17 40
7 10
^;^;^;^;^;^;^;^; ; ; ; ;^;^;^;^;^;^;^;^;^;^;^;^;^;^;^;^;^;^;^;^;^;^;^;^;^;^
^;^;^;^;^;^; ; ; ; ; ; ; ; ; ; ;^;^;^;^;^;^;^;^;^;^;^;^;^; ; ; ;^;^;^;^;^;^
^;^;^;^; ; ; ;#;#;#;#;#; ;#;#;#;:;#;#;#;#;#;#;:;^; ;^;^; ; ;e; ; ;^;^;^;^;^
^;^; ; ; ; ; ;#;i;_;w;#; ;#;_;_;_;_;_;+;_;_;_;#; ;^; ; ; ; ;^; ; ;^;^;^;^;^
^;^; ; ; ; ; ;#;_;_;w;#; ;#;_;_;w;_;_;#;_;_;_;#;^;^; ; ; ; ;^; ;^;^;^;^;^;^
^; ; ; ; ; ; ;#;#;e;#;#; ;#;_;_;_;_;_;#;#;,;#;#;e;^; ;^; ; ;^;^; ;^;^;^;^;^
 ; ; ; ; ; ; ; ; ; ; ; ; ;#;#;#;+;#;#;#; ; ; ; ; ; ;^; ;^;^;^; ;^; ;^; ;^;^
^; ; ; ; ; ; ; ; ; ; ; ; ; ; ; ; ; ; ; ; ; ; ; ; ; ; ; ; ; ; ; ; ;^; ; ;^;^
^; ; ; ; ; ; ; ; ; ; ; ; ; ; ; ; ; ; ; ; ; ; ; ; ; ; ; ; ; ; ; ; ; ;^; ; ; 
^;^; ; ; ; ; ; ; ; ; ; ; ; ; ; ; ; ; ; ; ; ; ; ; ; ; ; ; ; ; ; ; ; ; ;^; ;e
^;^;#;#;+;#; ; ; ; ;#;#;,;#;#; ; ; ;#;#;#;+;#;#;#; ;^;^;^; ;^; ; ; ; ;^;^;^
^;^;#;w;_;#; ; ; ;^;#; ; ; ;#; ; ; ;#;_;_;_;_;_;#; ;^;^; ; ;^;^; ; ;>; ;^;^
^;^;#;#;#;#; ; ;^;^;#; ;e; ;#; ; ; ;#;_;_;i;_;_;#; ; ;^; ;e; ; ;^; ; ; ;^;^
^;^;^;^;^;^;^;^;^;^;#;#;#;#;#;^; ; ;#;#;#;#;#;#;#; ;^; ;^; ; ; ;^;^; ; ;^;^
^;^;^;^;^;^;^;^;^;^;^;^;^;^;^;^;^; ; ; ; ; ; ; ; ;^;^;^;^;^; ; ; ;^;^;^;^;^
g 5 2 2 1 7 t
$ 200 250
o 8 2 2 1 7 ;
*|FOOD||t|t|2;"FOODS
t 32 5 40 1 7 ;
g 5 2 2 1 7 t
g 5 2 2 1 7 t
~|TORCH||t|t|1;"TORCHES
-|ARROW||t|t|12;"ARROWS
}|SHORT BOW {|}|t|;|3;1;10
$ 20 20
o 8 2 2 1 7 ;