17 40
8 3
_;_;_;_;_;_;_;.;_;_;_;_;_;_;_;.;_;_;_;_;_;_;_;_;_;_;_;_;.;_;_;_;_;_;_;_;_;_
_;_;_;_;_;_;_;#;#;#;#;#;#;#;#;#;_;_;_;_;_;_;_;_;_;_;_;_;:;:;:;:;_;_;_;_;_;_
_;_;_;_;_;_;_;#;_;_;+;_;+;_;_;#;#;#;#;#;#;#;#;#;#;#;#;#;#;_;_;:;_;_;_;_;_;_
_;_;_;_;_;_;_;#;_;_;#;_;#;_;_;+;_;_;.;_;_;_;_;_;_;.;_;_;:;_;>;#;_;:;_;_;:;_
_;_;_;_;_;_;_;#;_;_;#;_;#;_;_;#;_;_;#;_;_;_;_;_;_;#;_;_;#;_;_;#;_;#;_;_;#;_
_;_;_;_;_;_;_;#;#;#;#;+;#;#;#;#;_;_;.;#;#;#;#;#;#;.;_;_;#;#;#;#;:;#;#;#;#;.
_;_;_;_;_;_;_;_;_;#;_;_;_;_;_;_;_;_;_;#;_;_;_;_;#;_;_;_;_;_;_;_;_;_;#;_;_;_
_;_;_;_;_;_;_;_;_;+;_;_;_;_;_;_;_;_;_;+;_;<;#;_;+;_;_;_;_;_;_;_;_;_;:;_;_;_
_;_;_;_;_;_;_;_;_;#;_;_;_;_;_;_;_;_;_;#;_;_;_;_;#;_;_;_;_;_;_;_;_;_;_;_;_;_
_;_;_;_;_;_;_;#;#;#;#;+;#;#;#;#;_;_;.;#;#;#;#;#;#;.;_;_;#;#;#;#;+;_;_;_;:;.
_;#;#;+;#;#;_;#;_;_;#;_;#;_;_;#;_;_;#;_;_;_;_;_;_;#;_;_;#;_;_;#;_;:;_;_;#;_
_;#;_;_;_;#;_;#;_;_;#;_;#;_;_;+;_;_;.;_;_;_;_;_;_;.;_;_;+;_;_;#;_;#;_;_;#;_
_;#;_;_;_;#;_;#;_;_;+;_;+;_;_;#;#;#;#;#;#;#;#;#;#;#;#;#;#;_;_;,;_;+;_;_;#;_
_;#;#;#;#;#;_;#;#;#;#;#;#;#;#;#;_;_;_;_;_;_;_;_;_;_;_;_;#;:;_;:;#;#;#;#;#;_
_;_;_;_;_;_;_;.;_;_;_;_;_;_;_;.;_;_;_;_;_;_;_;_;_;_;_;_;.;_;_;_;_;_;_;_;.;_
$ 20 50
?|POTION||t|t|1;"POTIONS
]|SMALL SWORD [|]|t|;|5;60;11
$ 20 50
$ 20 50
g 5 2 2 1 7 t
o 8 2 2 1 7 ;
g 5 2 2 1 7 t
o 8 2 2 1 7 ;
$ 20 50
$ 20 50
-|ARROW||t|t|24;"ARROWS
*|BREAD||t|t|4;"BREADS
g 5 2 2 1 7 t
o 8 2 2 1 7 ;
g 5 2 2 1 7 t
o 8 2 2 1 7 ;
g 5 2 2 1 7 t
o 8 2 2 1 7 ;
g 5 2 2 1 7 t
)|SOFT LEATHER (|)|t|;|2;50;12
g 5 2 2 1 7 t