13 12
11 1
#;#;#;#;#;#;.;.;.;.
.;.;.;.;.;#;.;@1;.;.
.;.;@2;.;.;+;.;.;@0;.
.;.;.;.;.;#;.;,;.;.
#;#;#;#;#;#;#;+;#;#
#;#;#;#; ; ; ; ; ;#
#;#;#;#;#; ; ; ; ;#
#;#;#;#; ; ; ; ;#;#
#;#;#; ; ; ; ;#;#;#
#; ; ; ; ;#;#;#;#;#
>; ; ;#;#;#;#;#;#;#
