17 36
15 17
^;^;^;^;#;#;#;#;#;#;#;#;^;^;^;^;^;^;^;.;%;^;^;^;^;=;^;.;^;^;.;^;^;=
^;^;#;#;#;.;.;.;.;.;.;#;#;#;#;#;^;^;%;%;^;^;^;%;%;^;=;^;^;%;%;%;=;^
^;#;#;.;#;.;.;.;@6;.;.;#;.;@1;.;#;^;%;.;%;^;%;%;.;%;=;^;^;%;.;%;.;=;^
#;#;@3;.;,;.;.;.;.;.;.;#;.;.;.;#;%.;^;%;%;^;%;.;%;=;^;.;%;%;%;%;=;=;%
#;.;.;.;#;.;.;.;.;.;.;#;#;,;#;#;%;%;%;.;%;.;%;=;^;%;%;%;^;=;=;^;%;^
#;#;#;#;#;#;#;#;,;#;#;#;.;.;.;.;%;.;%;%;.;%;=;.;@2;%;.;^;=;%;%;%;.;^
^;.;.;.;.;.;.;.;.;.;.;.;.;.;.;.;.;%;%;.;=;=;.;%;%;.;^;=;=;%;.;%;^;^
^;.;@0;.;.;.;.;.;.;.;.;.;.;.;.;.;.;.;%;%;=;=;%;.;%;%;=;=;=;=;%;.;%;^
^;^;.;.;.;.;.;.;.;.;.;.;.;.;.;.;.;.;.;.;.;.;.;%;.;%;%;=;=;.;%;%;.;^
^;^;^;.;.;.;.;.;.;.;.;.;.;.;.;.;.;.;.;.;.;.;.;.;.;%;.;%;%;%;%;.;^;^
^;#;#;#;,;#;#;#;,;#;#;#;,;#;#;.;.;.;.;.;.;.;.;.;.;.;%;%;.;%;.;%;^;^
^;#;.;.;.;#;.;.;.;.;#;.;.;.;#;.;.;.;.;.;.;.;.;.;.;.;.;.;%;^;%;%;^;^
^;#;.;@7;.;#;.;.;@7;.;#;.;@7;.;#;.;.;.;.;.;.;.;.;.;@7;.;.;.;.;.;%;^;^;^
^;#;.;.;.;#;.;.;.;.;#;.;.;.;#;^;.;.;.;.;.;.;.;.;.;.;.;.;.;.;^;^;^;^
^;#;#;#;#;#;#;#;#;#;#;#;#;#;#;^;>;^;^;^;^;^;^;^;^;^;^;^;^;^;^;^;^;^

