17 40
2 2
#;#;#;#;#;#;#;#;#;#;#;#;#;#;#;#;#;#;#;#;#;#;#;#;#;#;#;#;#;#;#;#;#;#;#;#;#;#
#; ;#;#;#;#;#;#;#;#;#;#;#;#;#;#;#;#;#;#;#;#;#;#;#;#;#;#;#; ; ; ;#;#;#;#;#;#
#; ;#;#;#;#;#;#;#;#;#;#;#;#;#;#;#;#;#;#;#;#;#;#;#;#;#;#;#; ;e; ;#;#;#;#;#;#
#; ;#;#;#; ; ; ; ; ; ; ;:; ; ; ;e;#;#;#;#;#;#;#;#;#;#;#;#; ; ; ;#;#;#;#;#;#
#; ;#;#;e; ; ;:; ; ; ; ; ; ; ;:; ; ;#;#;#;#;#;#;#;#;#;#;#;#; ;#;#;#;#;#;#;#
#; ;#;#; ;:; ; ; ;:; ; ;:; ; ; ; ; ;#;#;#;#;#;#;#;#;#;#;#;#; ;#;#;#;#;#;#;#
#; ;#;#; ; ; ; ; ; ; ; ; ; ; ;:; ; ;#;#;#;#;#;#;#;#;#;#;#;#; ;#;#;#;#;#;#;#
#; ; ; ; ; ;:; ; ; ;:;e; ; ; ; ; ; ; ; ; ; ; ; ; ; ; ; ; ;:; ; ; ; ; ;e;<;#
#;#;#;#; ; ; ; ; ; ; ; ; ;:; ; ; ; ;#;#;#;#;#;#;#;#;#;#;#;#; ;#;#;#;#;#;#;#
#;#;#;#; ; ; ;:; ; ; ; ; ; ;:; ;:; ;#;#;#;#;#;#;#;#;#;#;#;#; ;#;#;#;#;#;#;#
#;#;#;#; ;:; ; ; ;:; ; ;:; ; ; ; ; ;#;#;#;#;#;#;#;#;#;#;#;#; ;#;#;#;#;#;#;#
#;#;#;#;#; ; ; ; ; ; ; ; ;:; ; ; ;#;#;#;#;#;#;#;#;#;#;#;#; ; ; ;#;#;#;#;#;#
#;#;#;#;#;#;#;#;#;#;#;#;#;#;#;#;#;#;#;#;#;#;#;#;#;#;#;#;#; ;e; ;#;#;#;#;#;#
#;#;#;#;#;#;#;#;#;#;#;#;#;#;#;#;#;#;#;#;#;#;#;#;#;#;#;#;#; ; ; ;#;#;#;#;#;#
#;#;#;#;#;#;#;#;#;#;#;#;#;#;#;#;#;#;#;#;#;#;#;#;#;#;#;#;#;#;#;#;#;#;#;#;#;#
o 8 2 2 1 7 ;
g 5 2 2 1 7 t
g 5 2 2 1 7 t
g 5 2 2 1 7 t
o 8 2 2 1 7 ;
o 8 2 2 1 7 ;