53 13
3 3
#;#;#;#;#;#;#;#;#;#;#
#;_;_;_;#;#;#;#;#;#;#
#;_;_;_;#;#;#;#;#;#;#
#;_;_;_;+; ;#;#;#;#;#
#;+;#;#;#; ;#;#;#;#;#
#; ;#;#;#; ; ; ; ; ;#
#; ;#;#;#;#;#;#;#;+;#
#; ;#;#;#;#;#;_;_;_;#
#; ; ; ; ; ;#;_;_w.;_;#
#;#;#;#;#; ;#;_;_;_;#
#;#;#;#;#; ;#;+;#;#;#
#;#;#;#;#; ;#;e ;#;#;#
#;#;#; ; ; ; ; ;#;#;#
#;#;#; ;#;#;#;#;#;#;#
#; ; ; ;#;#;#;#;#;#;#
#; ;#; ;#;#;#;#;#;#;#
#; ;#; ; ; ; ; ;#;#;#
#; ;#;#;#;#;#; ;#;#;#
#; ; ; ; ; ; ;e ; ; ;#
#;#;#; ; ; ; ; ; ; ;#
#;#;#; ; ; ; ; ; ; ;#
#;#;#;#;#; ; ; ; ; ;#
#;#;#;#;#; ; ; ; ; ;#
#;#;#;#;#; ;e ; ;e ; ;#
#; ; ; ;:; ; ; ; ; ;#
#; ;#;#;#;#;#;+;#;#;#
#; ;:; ; ; ;#; ; ; ;#
#;#;#; ;e ; ;#; ;e ; ;#
#;#;#; ; ; ; ; ; ; ;#
#;#;#;:;#;#;#;#;#;+;#
#;#;#; ;#;#;#;#;#; ;#
#;#;#;:;#;#;#;#;#; ;#
#;#;#;:;#;#;#;#;#; ;#
#;#;#; ;:; ;#; ; ; ;#
#;#;#;#;#;:;#; ;#;#;#
#;#;#;#;#; ;#; ;#;#;#
#;#;#;#;#;:;#;+;#;#;#
#;:;#;#;:;_;_;_;#;#;#
:;#; ;:;#;_;_w.;_;#;#;#
:;#;#;#;#;_;_;_;#;#;#
#;:;:;#;#;+;#;+;#;#;#
#;< ;#;#;#; ;#; ;#;#;#
#;:;#;#;#; ;#; ;#;#;#
#;:;#;#;#; ;#; ;#;#;#
#; ;#;#;#; ;#; ;#;#;#
#; ;#;#;#; ;#; ;#;#;#
#;+;#;#;#; ;#; ;#;#;#
#;_;_;_;#; ;#; ;#;#;#
#;_;_;_;#; ;#; ;#;#;#
#;_;_;_;+; ; ; ;#;#;#
#;#;#;#;#;#;#;#;#;#;#
}|BOW {|}|t|;|5;50;11
o 8 2 2 1 7 ;
g 5 2 2 1 7 t
g 5 2 2 1 7 t
g 5 2 2 1 7 t
o 8 2 2 1 7 ;
o 8 2 2 1 7 ;
?|POTION||t|t|1;"POTIONS