17 40
1 1
#;#;#;#;#;#;#;#;#;#;#;#;#;#;#;#;#;#;#;#;#;#;#;#;#;#;#;#;#;#;#;#;#;#;#;#;#;#
#; ; ; ; ;+; ; ; ;#;#;#;#;_w ;:;_;_;_;:; ; ; ;e ;#;#;#;#;#;#;#;#;#;#;#;#;#;#;#
#; ; ;#;#;#; ; ; ;#;#;#;#;#;#;_;_;_;:; ; ;e ; ;#;#;#;#;#;#;#;#;#;#;#;#;#;#;#
#; ; ;#;#;#; ; ; ;+; ; ; ; ;+;_;_;_;+; ;e ; ; ;:; ; ; ; ;#;#;#;#;#;#;#;#;#;#
#;#; ;#;#;#;#;#;#;#;#;#;#;#;#;_;_;_;#;#;#;#;#;#;#;#;#; ;#;#;#;#;#;#;#;#;#;#
#;#; ;#;#;#;#;#;#;#;#;#;#;#;#; ; ; ;#;#;#;#;#;#;#;#;#;+;#;#;#;#;#;#;#;#;#;#
#;#; ;#;#;#; ; ; ; ; ; ; ; ; ; ; ;e ;#;#;#;#;#;#;#;#;#;_;#;#;#;#;#;#;#;#;#;#
#;#; ; ; ;:; ; ; ; ; ; ; ; ; ; ;e ; ;#;#;#;#;#;#;#;#;#;_< ;#;#;#;#;#;#;#;#;#;#
#;#;#;#;:;:; ; ; ; ; ; ; ; ; ;e ; ; ;#;#;#;#;#;#;#;#;#;_;#;#;#;#;#;#;#;#;#;#
#;#;#;#;#;#;#;#;#;:;#;#;#;#;#;#;#;:;#;#;#;#;#;#;#;#;#;+;#;#;#;#;#;#;#;#;#;#
#;#;#;#;#;#;#;#;#;_w ;#;#;#;#;#;#;#; ; ; ; ; ; ; ; ; ; ; ;#;#;#;#;#;#;#;#;#;#
#;#;#;#;#;#;#;#;#;#;#;#;#;#;#;#;#;#;#;#;#;#;#;#;#;#;#;#;#;#;#;#;#;#;#;#;#;#
}|BOW {|}|t|;|5;2;11
o 8 2 2 1 7 ;
o 8 2 2 1 7 ;
o 8 2 2 1 7 ;
g 5 2 2 1 7 t
g 5 2 2 1 7 t
g 5 2 2 1 7 t
?|POTION||t|t|1;"POTIONS
